1500,750,200,200
100,200,250,20,1
100,600,250,20,1
100,800,250,20,1
100,400,250,20,1
100,1000,250,20,1